{
  "mapname": "map_01.json",
  "tilesize_x": 100,
  "tilesize_y": 100,
  "grid": [
    [ "0", "0", "0", "0", "0", "0", "0", "0"],
    [ "0", "0", "0", "0", "0", "0", "0", "0"],
    [ "0", "0", "0", "0", "0", "0", "0", "0"],
    [ "0", "0", "0", "0", "0", "0", "0", "0"],
    [ "0", "0", "0", "0", "0", "0", "0", "0"],
    [ "0", "0", "0", "0", "0", "0", "P", "0"],
    [ "0", "0", "0", "0", "0", "0", "0", "0"],
    [ "0", "0", "0", "0", "0", "0", "0", "0"],
    [ "0", "0", "0", "0", "0", "0", "0", "0"],
    [ "0", "0", "0", "0", "0", "0", "0", "0"],
    [ "1", "1", "1", "1", "1", "1", "1", "1"],
    [ "1", "1", "1", "1", "1", "1", "1", "1"],
    [ "1", "1", "1", "1", "1", "1", "1", "1"]
  ]
}