{
  "mapname": "map_01.json",
  "tilesize_x": 100,
  "tilesize_y": 100,
  "grid": [
    [ "0", "0", "0", "0", "0", "0", "0", "0", "0", "0", "0", "0", "0", "0", "0", "0", "0", "0", "0", "0", "0", "0", "0", "0", "0" ],
    [ "0", "0", "0", "0", "0", "0", "0", "0", "0", "0", "0", "0", "0", "0", "0", "0", "0", "0", "0", "0", "0", "E1","0", "0", "0" ],
    [ "0", "0", "0", "0", "0", "0", "0", "0", "0", "0", "0", "0", "0", "0", "0", "0", "0", "0", "1", "0", "0", "E1","0", "0", "0" ],
    [ "0", "0", "0", "0", "0", "0", "0", "0", "0", "0", "0", "0", "0", "0", "0", "0", "0", "0", "0", "BC","0", "E1","0", "0", "0" ],
    [ "0", "0", "0", "0", "0", "0", "0", "0", "0", "0", "0", "0", "0", "0", "0", "0", "0", "0", "1", "0", "0", "0", "0", "0", "0" ],
    [ "0", "0", "0", "0", "0", "0", "P", "0", "0", "0", "0", "0", "E1", "0", "0", "0", "0", "0", "1", "0", "0", "0", "0", "0", "0" ],
    [ "0", "0", "0", "0", "0", "0", "0", "0", "0", "0", "0", "0", "0", "0", "0", "0", "0", "WJ","1", "0", "0", "0", "0", "0", "0" ],
    [ "0", "0", "0", "0", "0", "0", "0", "0", "0", "0", "0", "0", "0", "0", "0", "0", "0", "0", "1", "0", "0", "0", "0", "0", "0" ],
    [ "0", "0", "0", "0", "0", "0", "0", "0", "E1","0", "DJ","0", "0", "0", "0", "0", "0", "0", "1", "0", "0", "0", "0", "0", "0" ],
    [ "0", "0", "0", "0", "L", "0", "0", "0", "0", "E2","0", "0", "0", "0", "0", "0", "0", "0", "1", "0", "0", "0", "0", "0", "0" ],
    [ "1", "1", "1", "1", "1", "0", "3", "3", "1", "1", "1", "0", "0", "0", "1", "1", "1", "1", "1", "1", "1", "1", "1", "1", "1" ],
    [ "1", "1", "1", "1", "1", "0", "3", "3", "1", "1", "1", "0", "0", "0", "1", "1", "1", "1", "1", "1", "1", "1", "1", "1", "1" ],
    [ "1", "1", "1", "1", "1", "0", "3", "3", "1", "1", "1", "0", "0", "0", "1", "1", "1", "1", "1", "1", "1", "1", "1", "1", "1" ],
    [ "1", "1", "1", "1", "1", "0", "3", "3", "1", "1", "1", "0", "0", "0", "1", "1", "1", "1", "1", "1", "1", "1", "1", "1", "1" ]
  ]
}