{
  "tilesize_x": 50,
  "tilesize_y": 50,
  "grid": [
    [ "0", "0", "0", "0", "0", "0", "0", "0", "0", "0", "0", "0", "0", "0", "0", "0", "0", "0", "0", "0", "0", "0", "0", "0", "0", "0", "0", "0", "0", "0", "0", "0", "0", "0" ],
    [ "0", "0", "0", "0", "0", "0", "0", "0", "0", "0", "0", "0", "0", "0", "0", "0", "0", "0", "0", "0", "0", "0", "0", "0", "0", "0", "0", "0", "0", "0", "0", "0", "0", "0" ],
    [ "0", "0", "0", "0", "0", "0", "0", "0", "0", "0", "0", "0", "0", "0", "0", "0", "0", "0", "0", "0", "0", "0", "0", "0", "0", "0", "0", "0", "0", "0", "0", "0", "0", "0" ],
    [ "0", "0", "0", "0", "0", "0", "0", "0", "0", "0", "0", "0", "0", "0", "0", "0", "0", "0", "0", "0", "0", "0", "0", "0", "0", "0", "0", "0", "0", "0", "0", "0", "0", "L" ],
    [ "0", "0", "0", "0", "0", "0", "0", "0", "0", "0", "0", "0", "0", "0", "0", "0", "0", "0", "0", "0", "0", "0", "0", "0", "0", "0", "0", "0", "0", "0", "0", "1", "1", "1" ],
    [ "0", "0", "0", "0", "0", "0", "0", "0", "0", "0", "0", "0", "0", "0", "0", "0", "0", "0", "0", "0", "0", "0", "0", "0", "0", "0", "0", "0", "0", "0", "0", "1", "1", "1" ],
    [ "0", "0", "0", "0", "0", "0", "0", "0", "0", "0", "0", "0", "0", "0", "0", "0", "0", "0", "0", "0", "H", "0", "0", "0", "0", "0", "0", "0", "0", "0", "0", "1", "1", "1" ],
    [ "0", "0", "0", "0", "0", "0", "0", "0", "0", "0", "0", "0", "0", "0", "0", "0", "0", "0", "0", "0", "0", "0", "0", "0", "0", "0", "0", "0", "0", "0", "0", "1", "1", "1" ],
    [ "0", "0", "0", "0", "0", "0", "0", "0", "0", "0", "0", "0", "0", "0", "0", "0", "0", "0", "0", "0", "0", "0", "0", "0", "0", "0", "0", "0", "0", "0", "0", "1", "1", "1" ],
    [ "0", "0", "0", "0", "0", "0", "0", "0", "0", "0", "0", "0", "0", "0", "0", "0", "0", "0", "1", "1", "1", "0", "0", "0", "0", "0", "0", "0", "0", "0", "0", "1", "1", "1" ],
    [ "0", "0", "0", "0", "0", "0", "0", "0", "0", "0", "0", "0", "0", "0", "0", "0", "0", "0", "1", "1", "1", "0", "0", "0", "0", "0", "0", "H", "0", "0", "0", "1", "1", "1" ],
    [ "0", "0", "0", "0", "0", "0", "0", "0", "0", "0", "0", "0", "0", "0", "0", "0", "0", "0", "0", "0", "1", "0", "0", "0", "0", "0", "0", "0", "0", "0", "0", "1", "1", "1" ],
    [ "0", "0", "0", "0", "0", "0", "0", "0", "0", "0", "0", "0", "0", "0", "1", "1", "0", "0", "0", "0", "1", "0", "0", "0", "0", "0", "0", "0", "0", "0", "0", "1", "1", "1" ],
    [ "0", "0", "0", "0", "0", "0", "0", "H", "0", "0", "0", "0", "0", "0", "1", "1", "0", "0", "0", "0", "1", "0", "0", "I2", "0", "0", "1", "1", "0", "0", "0", "1", "1", "1" ],
    [ "0", "0", "0", "0", "0", "0", "0", "0", "0", "0", "0", "0", "0", "0", "0", "0", "0", "0", "1", "1", "1", "0", "0", "0", "0", "0", "1", "1", "0", "0", "0", "1", "1", "1" ],
    [ "0", "0", "0", "0", "0", "0", "0", "0", "0", "0", "0", "0", "0", "0", "0", "0", "0", "0", "1", "1", "1", "0", "0", "0", "0", "0", "1", "1", "0", "I2", "0", "1", "1", "1" ],
    [ "0", "0", "0", "0", "0", "0", "0", "0", "0", "0", "0", "0", "0", "0", "0", "0", "0", "0", "1", "1", "1", "0", "0", "0", "0", "0", "1", "1", "0", "0", "0", "1", "1", "1" ],
    [ "1", "1", "1", "1", "1", "1", "1", "1", "0", "0", "0", "0", "0", "0", "0", "1", "1", "1", "1", "1", "1", "0", "T", "T", "T", "0", "1", "1", "0", "0", "0", "1", "1", "1" ],
    [ "1", "1", "1", "1", "1", "1", "1", "1", "0", "0", "0", "0", "0", "0", "0", "1", "1", "1", "1", "1", "1", "0", "0", "Z2", "0", "0", "1", "1", "0", "0", "0", "1", "1", "1" ],
    [ "1", "1", "1", "1", "1", "1", "1", "1", "0", "0", "0", "I1", "0", "0", "0", "1", "1", "1", "1", "1", "1", "0", "0", "0", "0", "0", "1", "1", "T", "T", "T", "1", "1", "1" ],
    [ "1", "1", "1", "1", "1", "1", "1", "1", "0", "0", "0", "0", "0", "0", "0", "1", "1", "1", "1", "1", "1", "0", "0", "0", "0", "0", "1", "1", "0", "Z3", "0", "1", "1", "1" ],
    [ "1", "1", "1", "1", "1", "1", "1", "1", "0", "0", "0", "0", "0", "0", "0", "1", "1", "1", "1", "1", "1", "0", "0", "0", "0", "0", "1", "1", "0", "0", "0", "1", "1", "1" ],
    [ "1", "1", "1", "1", "1", "1", "1", "1", "T", "T", "T", "T", "T", "T", "T", "1", "1", "1", "1", "1", "1", "0", "0", "0", "0", "0", "1", "1", "0", "0", "0", "1", "1", "1" ],
    [ "1", "1", "1", "1", "1", "1", "1", "1", "0", "0", "0", "Z1", "0", "0", "0", "1", "1", "1", "1", "1", "1", "0", "0", "0", "0", "0", "1", "1", "0", "0", "0", "1", "1", "1" ]

  ]
}